NO patterns/green.xpm

SO patterns/blue.xpm

WE patterns/purple.xpm

EA patterns/red.xpm

F 220, 100, 100
C 225, 200, 210

1111       11111111111111
1001       10000000000001
1001111111110100000000001
1001000000000000000000001
11111111101100000111000001
100000000011000001110111111111111
11110111111111011100000010001
11110111111111011101010010001
11000000110101011100000010001
10000000000000001100000010001
10000000000N00001101010010001
11000001110101011111011110000111
11110111 1110101 101111010001
11111111 1111111 111111111111
