NO patterns/green.xpm
WE patterns/purple.xpm
SO patterns/blue.xpm
EA patterns/red.xpm

F 220,100,100
C 225,200,210

111111111111
10S000000011
101100000111
100100000001
111111111111