NO patterns/green.xpm
SO patterns/blue.xpm
WE patterns/purple.xpm
EA patterns/red.xpm

F 220,100,100
C 225,200,210

11110000111111
1001000010001
1001011010001
1001100110001
1000000000001
1000000000001
1000000000001
1000000000001
1001000010001
1001000010001
1001000010001
1011010010001
1100100101111